Subject,Semester,Year,ISE,MSE,ESE,Total
Maths,II,First,18,28,48,94
Phys,II,First,17,25,45,87
Chem,II,First,15,22,42,79
Maths,I,First,19,29,49,97
Phys,I,First,18,26,46,90
Chem,I,First,16,24,44,84
Maths,IV,Second,20,30,50,100
Phys,IV,Second,19,28,48,95
Chem,IV,Second,17,26,45,88
Maths,III,Second,19,29,49,97
Phys,III,Second,18,27,47,92
Chem,III,Second,16,25,43,84