Subject,Semester,Year,ISE,MSE,ESE,Total
Maths,II,First,25,40,80,145
Science,II,First,22,38,75,135
History,II,First,20,35,70,125
Maths,I,First,24,39,78,141
Science,I,First,23,37,76,136
History,I,First,21,36,72,129
Maths,IV,Second,26,42,82,150
Science,IV,Second,24,40,78,142
History,IV,Second,22,38,74,134
Maths,III,Second,25,41,81,147
Science,III,Second,23,39,77,139
History,III,Second,21,37,73,131